1111111111111111111111111111111111
1P00000000001100000000000000M00001
1000111110001100000000000000000001
10000000M0001100000111110000000001
1000000000000000000000010000000001
100000000000000000000001000M000001
1000000000111110000000010000000001
1000000000000010000000010000000001
1000000000000010000000010000000001
1000000C100000010000000010000MC001
100000M000000010000000010000000001
1000000000111110000000010000000001
1000C00000100C1000000010000C000001
1000000000000000000000010000000001
10000000M000000000000001000M000001
10M0000000000000000000010000000001
1000000000000000000111110000000001
100000C0000000000000010000000000E1
1111111111111111111111111111111111
