111111111111111111111111111111
1E000111000000000001010C010001
100000100100000001100100000001
10000000C0000000000000C0010001
100000100000010011000000000001
1000001000001C01C01000C0001111
111111100C0010010C100000000111
100001100000000010100001110001
100000000010001100000001100001
10000000000C0000C00C0001000001
10000000000C00000C000010000001
1000000000C0001100001000000001
10000C000000000001000000C00001
1000000000C000000100000100P001
1000000000011100C0000000100001
111111111111111111111111111111